NO ./texture/north.png
SO ./texture/south.png
EA ./texture/west.png
WE ./texture/west.png
F 54,54,123                              
C 9,9,42
        1111111111111111111111111
        1000000000110000000000001
        1011000001110000000000001
        1001000000000000000000001
111111111011000001110000000000001
1E0000000011000001110111111111111
11110111111111011100000010001
11110111111111011101010010001
11000000110101011100000010001
10000000000000001100000010001
10000000000000001101010010001
1100000101010101111101111000111
1111011111110101 101111010001
11111111 1111111 111111111111