SO ./texture/south.png
NO ./texture/north.png
WE ./texture/west.png
EA ./texture/west.png

F 54,54,123                               
C 9,9,42

11111111111111111111111111111
10000000000000000000000000001
10000000000011101111000010001
10011111100000000011001111101
10000000000000000000000000001
11111111111111111111111111111
10001111111100000000000000001
10000000000000000000111111101
10000000111111110011100000001
10000001111100000100001000001
1011111111110000000000D000001
10000000000111000000001000001
100000000001110000000W0000001
10000001111000010010010000001
10000000000001010010010100001
10111111100000000000011000001
10000000000000000000000000001
11111111111111111111111111111