NO ./Tileable1e.png
SO ./Tileable1e.png
  WE          ./Tileable1e.png             
      EA        ./Tileable1e.png

F 255,0,0
C 0,0,255

11111111111111111111111111111
10000000000000000001000010001
10000000000011101111000010001
10011111100000000011001111101
10000000000000000000000000001
10001111111100000000000000001
10000000000000000000111111111
10000000111111110011100000001
100000011111000S0000000000001
11111111111100000000000000001
10000000000111000000000000001
10000000000111000000000000001
10000001111000010010010000001
10000000000001010010010100001
11111111100000000000011000001
10000000000000000000001110011
11111111111111111111111111111
