NO ./texture/ north.png
SO ./texture/south.png
EA ./texture/west.png
WE ./texture/west.png
F 54,54,123                               
C 9,9,42
11111111111111111111111111111
10000000000000000000000000001
10000000000011101111000010001
10011111100000000011001111101
10000000000000000000000000001
11111111111111111111111111111
10001111111100000000000000001
1000000000000000000011D11101
1000000011111111001111D100001
1000000111110000010001D101001
1011111111110000000001D100001
10000000000111000000010100001 
1000000000011100000000N00001
10000001111000010010010000001
10000000000001010010010100001
10111111100000000000011000001
10000000000000000000000000001
11111111111111111111111111111