NO ./img.png
SO ./img.png
  WE ./img.png           
      EA        ./img.png

F 63,63,63
C 13,13,56

111111111111111111111111111111
100000000000000000000000000001
100000000000000000000000000001
100000000000000000000000000001
10000000E000000000000000000001
100000000000000000000000000001
100000000000000000000000000001
100000000000000000000000000001
100000000000000000000000000001
111111111111111111111111111111