NO ./png/img.png
SO ./png/img.png
  WE ./png/img.png           
      EA        ./png/img.png

F 63,63,63
C 13,13,56

111111111111111111111111111111
100000000000000000000000000001
100000000000000000000000000001
100000000000000000000000000001
100000001000000000000000000001
1000000000000000000000S0000001
100000000000000000000000000001
100000000000000000000000000001
100000000000000000000000000001
111111111111111111111111111111