NO ./img.png
SO ./n.png
  WE          ./w.png          
      EA        ./door.png
F 0,51,25
C 0,128,255

11111111111111111111111111111
10000000000000000001000010001
1000001D100011101111000010001
10011111100000000011001111101
10000000000000000000000000001
10001111111100000000000000001
10000000000000000000111111111
10000000111111110011100000001
100000011111000S0000000000001
11111111111100000000000000001
1000000000011111D111100000001
10000000000111000000000000001
10000001111000010010110000001
10000000000001010010010100001
111111111000C0000000011000001
10000000000000000000001110011
11111111111111111111111111111
