NO ./img-1.png
SO ./img-2.png
  WE          ./img-3.png            
      EA        ./img.png

F 255,0,0
C 0,0,255

11111111111111111111111111111
10S00000000000000000000000001
10000000000000000000000000001
10000000000000000000000000001
10000000000000000000000000001
10000000000000000000000000001
10000000000000000000000000001
10000000000000000000000000001
11111111111111111111111111111
